0000000000000000000000000000000
0111111111111100001111111111110
0100000100000100001000010000010
0200000100000100001000010000020
0111111111111111111111111111110
0100000100100000000001010000010
0100000100100000000001010000010
0100000100100000000001010000010
0111111100111110011111011111110
0000000100000090090000010000000
9999990100999999999990010999999
9999990100990000000990010999999
0000000100990999990990010000000
9999999199990999990999919999999
0000000100990000000990010000000
9999990100999999999990010999999
9999990100990000000990010999999
0000000100990000000990010000000
0111111111111110111111111111110
0100000100000010100000010000010
0200000100000010100000010000020
0111100111111111111111110011110
0000100100100000000010010010000
0111111100111100011110011111110
0100000000000100010000000000010
0100000000000100010000000000010
0111111111111111111111111111110
0000000000000000000000000000000